5555555555555555555555555555
5004444444444004444444444005
5004444444444004444444444005
5444440000000000000000444445
5444440055555000555500444445
5444440050055000500500444445
5444440050055000500500444445
5444440055555000500500444445
5444440000005000500500444445
5444440000005000500500444445
5444440000005000500500444445
5444440055555000555500444445
5444444444444444444444444445
5444444444444444444444444445
5444444444444444444444444445
5550000000000550000000000555
5550000000011551100000000555
5220000000011111100000000225
5221100110011111100110011225
5221111111111111111111111225
5221111111111111111111111225
5221100110011001100110011225
5220000000000000000000011225
5220000000000000000000011225
5221151150000000005115011225
5222219010000000001901222225
5222210010001001001001222225
5555555555555555555555555555